# # # # # # #
# . # . . . # 
# . # . # . #
# . # . # . #
# . . . # . #
# . # . . . #
# # # # # # #

